25 13
#########################
####a..........a###.a####
#####.....#....####..####
#######...#.#........####
########......#.###..####
########a##A#....##..####
##........#...##.##..####
##.A.##.........A..#.####
#.A.....##...##...##.####
#.##A.#.##.###....##...##
#.##.AA..@.#########.#.##
#......####a...........##
#########################