10 10
##########
#....a...#
#....A...#
#........#
#...##...#
#..###...#
#.A@..A..#
#.#A....a#
#..##....#
##########
