20 12
####################
####...........a####
#####..........#####
#######......#######
########.....#######
########a##A#....###
#.........#...##.###
##...#####......A..#
##....####...##...##
####..####.###....##
######...@.#########
####################